?#################|bbbbbbbbbbbbbbbbbbbbbbbbb|
?                 |                         |
?                 |aaaaaaa                  |
?                 |                         |
?    =            |                         |
?    =            |                         |
?    =            |################|        |
?                                  |        |
?                                  |        |
?            ...                   xxxxxxx  |
?            ...     *                      |
?            ...                   xxxxxxx  |
?                                  |        |
?                                  |        |
?                                  |        |
?@@@@@@@@@@@@@@@-----------------------------
